###########################
#P.....~...........~....G#
#...###.........~~~..###..#
#...#...###..........#....#
#...#..#...#....#####.#...#
#...#..#...#....#...#.#...#
#...#..#...#....#...#.#...#
#...#..#...#....#...#.#...#
#...#..#####....#...#.#...#
#...#.........###...#.#...#
#...#.............~.#.#...#
#...#...............#.#...#
#...#...............#.N...#
#...#########....####.#...#
#....................#...#..#
###########################
